..................................................
..................................................
...................X..............................
.........X.........X..............................
X.X.X.X.X.X.X.X.XXXXXXXXXXXXXXX.X.X.X.X.X.X.X.X.X.
............############################..........
............................X.....................
..................................................
................X...........................X.....
..................................................