#####....###########..####......#####.....########
#............#..............#....................#
#...........................#....................#
#............#..............#....................#
######X##############X#################.##########
..................................................
####.###############X##################X##########
#............#..............#....................#
#...........................#....................#
#............#..............#....................#
###......########.######.#....######......########